{
	"width": 2921,
	"height": 1676.4,
	"scale": 25,

	"layout": [ ".D......................D.",
				"..........................",
				"..........................",
				"..........................",
				"..........................",
				".........................L",
				"..........................",
				"..........................",
				"R.........................",
				"..........................",
				"..........................",
				".........................L",
				"..........................",
				"..........................",
				"..........................",
				"..........................",
				"..........................",
				"..U...............U......." ]
}